responsibility = 책임, 직무
convenience = 편리, 편의
request = 요청, 요구, 요청하다
surgery = 수술
eternity = 영원, 오랜 시간
jargon = 전문어, 용어
terminology = 용어
discipline = 학문 분야, 훈육, 규율
trajectory = 궤도
circumstance = 환경, 상황
arena = 분야, 무대, 경기장
manipulate = 손쉽게 처리하다, 다루다, 조작하다
aroma = 향기, 향
sweetener = 감미료
assess = 평가하다, 재다
bizarre = 기이한, 특이한
respondent = 응답자
proportion = 비율, 부분
merchant = 상인
moisture = 습기
automatically = 자동으로
enrich = 풍요롭게 하다, 부유하게 하다
cultivate = 키우다, 구축하다, 경작하다
account = 계정, 계좌, 장부, 설명하다, 원인이 되다
variety = 다양성, 여러 가지, 품종
sermon = 설교
rational = 합리적인, 이성적인
disproportionate = 불균형적인, 균형이 안 맞는
exaggerate = 더 두드러지게 하다, 과장하다
irrelevant = 무관한, 상관없는
