suffer = 고통받다, 입다, 겪다
suburban = 교외의
affluent = 부유한, 풍족한
agenda = 안건, 의제, 행동강령
handle = 다루다, 처리하다, 손잡이, 핸들
dignify = 품위를 높이다, 품위 있어 보이게 하다
fierce = 맹렬한, 격렬한, 사나운
sense = 감지하다, 느끼다, 감각, 느낌
integrity = 완전성, 무결성, 진실성
explode = 폭발적으로 증가하다, 폭발하다
deal = 다루다, 처리하다, 거래하다, 거래, 합의, 많음
impair = 손상시키다
prioritize = 우선시하다, 우선순위를 정하다
crash = 고장 나다, 충돌하다, 추락하다, 사고, 굉음, 급강하, 폭락
merge = 통합하다, 합치다
spread = 확산하다, 퍼뜨리다, 확산, 전파
recommendation = 추천, 추천서
prominent = 중요한, 두드러진, 저명한
rely = 의존하다, 의지하다
manifestation = 징후, 조짐
enemy = 적, 적군, 경쟁 상대
terrain = 지형, 지역, 여지
tribe = 부족, 종족
simplify = 단순화하다
evident = 분명한, 명백한, 나타나는
fertile = 비옥한, 기름진, 생식력 있는, 풍부한
disperse = 흩어지게 하다, 전파하다
military = 군대, 군인들, 군대의
postpone = 미루다, 연기하다
cluster = 덩어리, 무리, 결합하다, 모이다
