issue = 발행하다, 공표하다, 문제, 주제, 쟁점, 사안
concern = 우려, 걱정, 관심, 우려하게 만들다, 흥미를 갖다
principal = 교장, 주요한
ruin = 망치다, 파멸시키다, 유적, 폐허
inconsiderate = 사려 깊지 못한
shrug = 어깨를 으쓱하다, 어깨를 으쓱하기
squeeze = 꼭 잡다, 짜다, 꽉 쥐기, 짜기
singular = 단일한, 단수형의, 뛰어난, 단수형
credit = 공로, 학점, 신용
exclusively = 전적으로, 독점적으로
falsified = 거짓의, 위조된
politician = 정치인, 정치가
assertion = 주장, 행사
blur = 흐릿해지다, 흐릿하게 하다
ignite = 불을 붙이다, 촉발하다, 불러일으키다
ambiguity = 모호함, 애매함
process = 과정, 공정, 진행, 처리하다
mindset = 사고방식
antipathy = 반감
conviction = 확신, 유죄 판결, 신념
critical = 중요한, 비판적인
outperform = 뛰어나다, 능가하다
omission = 생략, 누락, 빠짐
embrace = 수용하다, 받아들이다
mediate = 전달하다, 중재하다, 조정하다
enthusiast = 열정적인 사람, 광
parameter = 특성, 매개 변수, 한계
democracy = 민주주의, 민주 국가, 평등
retire = 은퇴하다, 자리를 뜨다
diagnose = 진단하다
