polar = 극지방의
unforgettable = 잊을 수 없는
facility = 시설, 설비
compartment = 칸, 객실
trait = 특성, 특색
standardized = 표준화된
temperament = 기질, 괴팍함
treat = 취급하다, 치료하다
regard = 간주하다, 고려
retrieve = 되찾다, 회수하다
trap = 덫, 올가미, 함정, 가두다, 끼이다
expend = 소비하다, 들이다, 쓰다
sequential = 연속적인, 순차적인
threshold = 임계치, 문턱, 문지방
encode = 암호화하다, 부호화하다
cognition = 인지, 인식
guarantee = 보장, 보증서, 보장하다, 장담하다
consistent = 일치하는, 일관된
inherent = 본질적인, 고유한
ancestor = 조상, 선조
intention = 목적, 의도, 의사
scent = 향기, 향내
offspring = 새끼, 자식
spatial = 공간의, 공간적인, 공간에 존재하는
directly = 직접적으로, 곧장, 똑바로
condiment = 조미료, 양념
tough = 힘든, 어려운, 강인한
enterprise = 기업
competitor = 경쟁자, 참가자
recession = 불황, 불경기
