weave = (이야기 등을) 짜다, 엮다, (옷감 등을) 짜다
inferior = 열등한, (질이) 더 낮은
chunk = 덩어리
unlock = 풀다, (잠겨 있는 것을) 열다
drawback = 결점, 단점, 약점
binary = 2진수의, 2진법의
breastfeed = 모유를 먹이다
dairy = 유제품, 낙농의
symmetry = 대칭, 균형
flammable = 불에 잘 타는, 인화성의
enlarge = 크게 하다, 확장하다, 확대하다
chew = 씹다
necessitate = ~을 필요하게 만들다
liberation = 해방
displace = 대체하다, 대신하다, (살던 곳에서) 쫓아내다
steady = 안정적인, 꾸준한
resolve = 해결하다, 결심하다
depth = 깊이
mutual = 상호적인, 상호 간의, 서로의
outcome = 결과(물), 성과
influential = 영향력이 큰, 영향력 있는
breaded = 빵가루를 묻힌, 입힌
border = 접경하다, 국경, 경계
rebellious = 반항적인
landmass = 광대한 땅, 대륙
clan = 일족, 씨족, 일문
hardy = 강인한, 강한
empirical = 실증적인
auditory = 청각적인, 청각의
rationale = 근거, 이유
