livestock = 가축
correlation = 상관관계
disposition = 성향, 기질
clever = 재치 있는, 영리한, 똑똑한
analogy = 비유, 유사점
crop = 작물, 수확량
nutrient = 영양소, 영양분
nitrogen = 질소
population = 인구, 주민
ensure = 보장하다
suspicious = 수상쩍은, 의심스러운
reception = 접수처, 리셉션(축하연회)
protection = 보호
encourage = 장려하다, 격려하다, 권장하다
substitute = 대체하다, 대체물, 대리자
seemingly = 겉보기에는, 외견상으로
blood = 피, 혈액
breathe = 호흡하다
concentration = 농도, 집중
highlight = 강조하다, 가장 좋은 부분, 하이라이트
enforce = 시행하다, 집행하다
transportation = 교통, 교통수단
hire = 대여, 고용하다, 대여하다
track = 추적하다, 육상, 길
designated = 지정된
paradox = 역설
evolution = 진화
ape = 유인원
statistics = 통계(자료), 통계학
manuscript = 원고
