typical = 전형적인
horror = 공포, 전율
discordant = 맞지 않는, 조화를 이루지 못하는
harsh = 거친, 가혹한
universe = 세계, 우주
brave = 용기 있는, 용맹한
align = 맞추다, 부합하게 하다
achieve = 이루다, 달성하다, 성취하다
burnout = 극도의 피로, 탈진
ample = 충분한, 넉넉한
contrary = 반대되는, 어긋나는, 거꾸로의, 반대, 반대되는 것
mantra = 주문
prophet = 예언자, 선지자
enslave = 노예로 만들다, 노예가 되게 하다
addiction = 중독
scam = 사기, 속이다
source = 정보원, 원천, 근원
unbiased = 편견이 없는, 공정한
guess = 추측하다, 짐작하다, 추측, 짐작
exhibit = 보이다, 전시하다, 전시물, 전시
empathize = 공감하다
indecisive = 우유부단한, 결단력이 없는
adept = 능숙한
signal = 신호, 신호하다, 신호를 주다
boredom = 지루함, 따분함
contemplate = 고찰하다, 눈여겨보다, 숙고하다
puzzle = 어리둥절하게 만들다, 당황하게 하다, 퍼즐, 수수께끼, 당혹
manage = 관리하다, 조종하다, 실현하다
disease = 질병, 질환
persuade = 설득하다
