regime = 제도, 정권
urgency = 긴급, 위급, 긴급한 일
zealous = 열성적인, 열심인
attraction = 매력, 명소
trust = 신뢰, 신뢰하다
emergent = 창발적인, 새롭게 나타난, 신흥의
microbe = 미생물
tiny = 아주 작은
counterpart = 상응하는 것, 상대방, 한쪽
wipe = 일소하다, 쓸어 없애다, 닦아 없애다
mineral = 광물, 무기물
continent = 대륙, 육지
progress = 발전, 진전, 나아감, 진행되다, 전진하다
amount = 양, 총액
habituate = 익숙해지다, 습관 들게 하다
primate = 영장류
spoil = 상하게 하다, 망치다
advantage = 이점, 우위, 이익
threat = 위협
negative = 부정적인, 소극적인, 음의, 마이너스의, 부정, 부인, 음성
captivate = 사로잡다, 현혹시키다
intent = 의도, 의향
execution = 실행, 실시, 처형
compulsive = 강박적인, 충동적인
sway = 흔들다, 영향을 주다
purpose = 목적, 의도
frame = 구성하다, 만들다, 액자, 틀
narrator = 말하는 사람, 서술자, 내레이터
console = 위로하다, 달래다
wrestle = 씨름하다, 싸우다
