relief = 안도, 안심
share = 점유율, 몫, 공유하다, 나누다
vehicle = 차량, 수단, 도구
autonomous = 자율적인
lengthy = 너무 긴, 장황한, 지루한
mimic = 모방하다, 흉내를 내다
policy = 정책, 방침
immigrant = 이민자, 이주민
ethnic = 민족의, 인종의
predominate = 지배하다, 우위를 차지하다
indigenous = 토착의, 원산의
interchangeably = 상호 호환적으로, 서로 바꿔서, 교대로
pessimistic = 비관적인
tangible = 유형의, 분명히 실재하는, 만질 수 있는
quote = 인용하다
copyright = 저작권, 판권
qualify = 자격을 얻다
eligible = 자격이 있는, 적임의, 적당한
lyric = 가사, 노랫말
indicate = 나타내다, 시사하다
spontaneously = 자연스럽게, 자발적으로
display = 표시하다, 진열하다, 전시하다, 전시, 표현
mammal = 포유류, 포유동물
scale = 비례하다, 오르다, 비늘을 벗기다, 규모, 비늘, 음계
miraculous = 놀라운 만큼, 기적적인
sophomore = 2학년생
confess = 고백하다, 인정하다
figure = 생각하다, 판단하다, 계산하다, 형상, 인물, 숫자
admire = 감탄하다, 찬사를 보내다
raw = 다듬어지지 않은, 가공되지 않은, 날것의
