content = 콘텐츠, 내용(물)
incidental = 우연한, 부수적인
theory = 이론, 학설
principle = 원칙, 원리
insincere = 불성실한
immense = 엄청난
invoke = 언급하다, 떠올리다, 적용하다
slot = 시간대, 자리, 구멍
upset = 혼란 상태, 당황함, 속상한, 속상하게 만들다
awake = 깨어 있는, 깨우다
matter = 중요하다, 문제, 상황
meaningful = 유의미한, 중요한
reserve = 따로 잡아 두다, 예약하다
manipulation = 조작
latitude = 위도
fine = 세밀한, 미세한, 질 높은, 좋은, 벌금
isolate = 격리하다, 고립시키다
retreat = 물러나다, 후퇴하다, 휴양지, 후퇴, 도피
deprive = 앗아가다, 빼앗다
pretend = 주장하다, 흉내를 내다
ratio = 비율
attend = 다니다, 참석하다
poet = 시인
accompany = 동행하다, 수반하다
nonprofit = 비영리의, 비영리 단체
formal = 공식적인, 공적인, 정규의
enact = 구헌하다, 행하다, 규정하다
flip = 던지다, 뒤집다
bet = 내기, 돈을 걸다
predator = 포식자
