manifest = 나타내다, 표현하다, 분명한
traumatic = 외상의, 매우 충격적인
maladaptive = 부적응적인, 순응성이 없는
vigilance = 경계, 조심
sophisticated = 정교한, 세련된
judge = 판단하다, 평가하다, 판사
alert = 경고하다, 알리다, 경계하는, 기민한
collision = 충돌, 대립
present = 제공하다, 발표하다, 현재의, 있는, 존재하는, 선물
cell = 세포, 감방
persist = 지속되다, 계속되다
sustain = 유지하다, 지탱하다
approach = 접근하다, 다가가다, 접근 방식, 접근법
recite = 암송하다, 낭독하다
reproduce = 재생하다, 재생산하다, 복사, 복제하다, 번식하다
psychological = 심리적인
perception = 인식, 자각
realm = 영역
sensory = 감각적인, 감각의
continuum = 연속체
neuron = 뉴런, 신경 세포
input = 입력, 투입
correspond = 일치하다, 상응하다, 편지를 주고받다
proponent = 지지자, 옹호자
restore = 회복시키다, 복원하다
preparation = 준비, 대비
spur = 불러일으키다, 자극하다, 박차를 가하다, 자극, 박차, 원동력
enlist = 입대하다, 징집하다, 협조, 참여를 요청하다, 얻다
reduction = 감소, 축소, 삭감
climatologist = 기후학자, 기후통계학자
