compassionate = 인정 많은, 동정심 많은
equation = 방정식, 균등화
magnitude = 크기, 규모
response = 반응, 응답
buffer = 완충제, 완충 장치, 완화하다
inhabitant = 서식 생물, 주민, 거주자
diagram = 도식, 도해, 도표
improvise = 즉흥적으로 연주하다, 즉석에서 만들다
chemistry = 화학, 화학적 성질
straightforward = 간단한, 솔직한
recipe = 조리법
desirability = 바람직함
mobility = 기동력, 이동성
distribute = 분배하다, 나누어 주다, 분포시키다
inclination = 경향, 의향, 경사(도)
statesman = 정치가, 정치인
superstitious = 미신적인, 미신을 믿는
beneficial = 유익한
neglect = 도외시하다, 등한시하다, 소홀히 하다
aware = 인식하고 있는, 알고 있는
prayer = 기도(문), 기원, 희망
bond = 결속시키다, 유대
inspire = 고취하다, 영감을 주다
cohesion = 결합, 응집력
descent = 혈통, 하강, 전락
infant = 유아, 아기
dictate = 지시하다, 결정하다, 받아쓰게 하다
disparity = 격차, 차이
curiosity = 호기심
nuance = 미묘한 차이, 뉘앙스
