glacier = 빙하
voyage = 항해(기), 항해하다
flora = 식물군
relentless = 끈질긴, 수그러들지 않는, 가차 없는
conceive = 생각하다, 이해하다
renowned = 유명한
scorn = 비웃다, 경멸하다, 경멸, 멸시
passage = 통행, 통과
community = 공동체, 지역 사회
destiny = 운명
scroll = (화면을) 넘기다, (화면을) 스크롤 하다
deem = 간주하다, 여기다
insult = 신체적 손상, 모욕, 모욕하다, 무례하게 대하다
passive = 수동적인, 소극적인
bomb = 폭탄으로 공격하다, 폭격하다, 폭탄
discard = 버리다, 폐기하다
disposable = 일회용품, 일회용의
personnel = (전)직원, (전)사원, 인사과
disinfection = 살균, 소독
prone = 취약한, 하기 쉬운, 당하기 쉬운, 경향이 있는
fragment = 조각, 파편, 산산이 부서지다, 분해하다, 분열하다
favorable = 유리한, 호의적인
underscore = 강조하다, 밑줄을 긋다
lineage = 계통, 혈통
transaction = 거래, 처리
resilient = 탄력 있는, 회복력 있는
morale = 사기, 의욕
guideline = 지침, 가이드라인
leak = 누출, 새는 곳, 새어 나옴, 새게 하다, 새다
contest = 논쟁하다, 이의를 제기하다, (경시)대회, 시합, 경쟁
