precipitation = 강수량
arid = 메마른, 무미건조한
frost = 서리, 성에
presentation = 발표, 제시
interaction = 상호 작용
foster = 촉진하다, 북돋다, 조성하다
refrain = 자제하다, 삼가다
instructional = 교육의
academic = 학업의, 학문의
pedagogical = 교육의, 교육적인, 교육학의
crystal-clear = 아주 명료한, 명백한
structure = 구조
section = 섹션, 일부, 구역
general = 일반적인
mechanical = 기계적인
oddly = 이상하게, 기이하게
anthropologist = 인류학자
private = 개인의, 개인 소유의, 사유의
entitle = 권리를 주다, 자격을 주다
insane = 제정신이 아닌, 정신 나간
breakdown = 실패, 고장, 와해
soar = 날아오르다, 급증하다, 치솟다
discourage = 낙담시키다, 억제하다
landslide = 산사태
obstacle = 장애물, 걸림돌
fulfill = 이루다, 달성하다, 충족시키다
determine = 결심하게 하다, 결정하다
challenging = 어려운, 힘든, 도전적인
guardian = 후견인, 보호자, 수호자
patience = 인내
