captivity = 우리, 감금
nonsense = 무의미한, 말도 안 되는, 터무니없는 생각, 말
remind = 상기시키다, 생각나게 하다
recall = 기억해 내다, 상기하다
vowel = 모음
arrangement = 배열, 타협, 협정, 마련
exact = 정확한
identify = 동일시하다, 확인하다, 파악하다
necessary = 필요한
overlapping = 겹치는, 중복된
practical = 실제적인, 실용적인
practice = 관례, 관행, 실행, 연습
decade = 10년
draw = 도출하다, 끌다, 뽑아내다, 그리다, 추첨, 무승부
sequence = 배열 순서를 밝히다, 배열하다, 순서, 차례
flooding = 범람, 홍수
growth = 증가, 성장
lead = 이끌다, 안내하다, 지도, 인도
combat = 전투, 싸우다
exercise = 운동하다, 발휘하다, 운동
regular = 규칙적인, 정기적인
organism = 유기체
fairly = 꽤, 상당히, 타당하게
efficacy = 효능감, 효능
boost = 증진하다, 높이다
seek = 추구하다, 찾다
retrace = 되짚어가다, 추적하다
keystone = 쐐기돌, 핵심
swell = 부풀어 오르다, 벅차오르다
scatter = 흩어지게 하다, 흩뿌리다
